3 0 0 0 2 0 0 0 0 2 0 0 0 0 2 0 0 0 0 2
1 1 1 1 1 1 1 1 1 1 1 1 1 1 1 1 1 1 1 1
8 8 6 6 7 7 6 6 7 7 6 6 7 7 6 6 7 7 11 9
8 8 4 4 5 5 4 4 5 5 4 4 5 5 4 4 5 5 11 9
8 8 4 4 5 5 4 4 5 5 4 4 5 5 4 4 5 5 11 9
8 8 5 5 4 4 5 5 4 4 5 5 4 4 5 5 4 4 10 9
8 8 5 5 4 4 5 5 4 4 5 5 4 4 5 5 4 4 10 9
8 8 4 4 5 5 4 4 5 5 4 4 5 5 4 4 5 5 11 9
8 8 4 4 5 5 4 4 5 5 4 4 5 5 4 4 5 5 11 9
8 8 5 5 4 4 5 5 4 4 5 5 4 4 5 5 4 4 10 9
8 8 5 5 4 4 5 5 4 4 5 5 4 4 5 5 4 4 10 9
8 8 4 4 5 5 4 4 5 5 4 4 5 5 4 4 5 5 11 9
8 8 4 4 5 5 4 4 5 5 4 4 5 5 4 4 5 5 11 9
8 8 6 6 6 6 6 6 7 7 6 6 7 7 6 6 7 7 11 9